111111111111111111111
10010000000C0110000C1
1000011111000CC0000C1
100011E000000CC1110E1
1111110000E100CCCCC11
10010000000C0110000C1
1000011111000CC0000C1
1P0011E000000CC1110E1
1111110000E100CCCCC11
111111111111111111111
